recently  : 최근에
currently : 현재
in total  : 합해서
the one where I used to live : 내가 살던 집
hanging on the wall : 벽에 걸려 있다.
It's big enough for me to live : ~ 하기에 충분히 크다.
It's just big enough for me to live : ~ 하기에 딱 맞게 크다.
it's cozy, It's good for me : 나에게 좋다.
different from : ~ 와 다르다
until recently : 최근까지
it's, there are
there are many public transportation options
i can go anywhere i want in a short time : 짧은 시간 안에 내가 원하는 곳을 갈 수 있다.
studio apartment : 원룸
one bedroom : 투룸
let me tell you a story about me : 나에대한 얘기를 해줄게
one great thing about my place is that it's in great location : 한가지 좋은점은 위치가 좋았다.

typlcally : 일반적으로
almost always : 거의 항상
always : 항상
usually : 거의

I make sure to go toilet before before the movie starts : 나는 꼭 화장실을 간다.
when i get home : 집에 도착하면
Once I get to the theater : 영화관에 도착하면
it's interesting to see : 보는 것은 즐겁다.
check out : 확인하다.
talk about : 얘기 나누다. 
discuss : 얘기 나누다.
meaning : 의미

he is almost invincible : 그는 거의 무적이다.
he has a good looking : 그는 잘생겼다.
he fight a villain off: 그는 악당을 무찌른다.

I think crime city is one of the funniest movie he starred : 그가 출연한 영화 중 범죄 도시가 가장 재밌는 것 같다.

feature, star : 출연하다

like i just said before : 내가 좀 전에 말했듯이 